6 1 1 1 1 1 1 1 5 1 1 1 1 1 1 7
4 5 5 5 5 5 5 5 5 5 5 5 5 5 5 2
4 5 5 5 5 5 5 5 5 5 5 5 5 5 5 2
4 5 5 5 5 5 5 5 5 5 5 5 5 5 5 2
4 5 5 5 5 5 5 5 5 5 5 5 5 5 5 2
4 5 5 5 5 5 5 5 5 5 5 5 5 5 5 2
4 5 5 5 5 5 5 5 5 5 5 5 5 5 5 2
4 5 5 5 5 5 5 5 5 5 5 5 5 5 5 2
4 5 5 5 5 5 5 5 5 5 5 5 5 5 5 2
4 5 5 5 5 5 5 5 5 5 5 5 5 5 5 2
4 5 5 5 5 5 5 5 5 5 5 5 5 5 5 2
9 3 3 3 3 3 3 3 5 3 3 3 3 3 3 8
  
 6 1 1 1 1 1 1 1 11 1 1 1 1 1 1 7 
 4 5 5 5 5 5 5 5 11 5 5 5 5 5 5 2 
 4 5 5 5 5 5 5 5 11 5 5 5 5 5 5 2 
 4 5 5 5 5 5 5 5 11 5 5 5 5 5 5 2 
 4 5 5 5 5 5 5 6 11 7 5 5 5 5 5 2 
 12 12 12 12 12 12 12 12 5 12 12 12 12 12 12 12 
 4 5 5 5 5 5 5 9 11 8 5 5 5 5 5 2 
 4 5 5 5 5 5 5 5 11 5 5 5 5 5 5 2 
 4 5 5 5 5 5 5 5 11 5 5 5 5 5 5 2 
 4 5 5 5 5 5 5 5 11 5 5 5 5 5 5 2 
 4 5 5 5 5 5 5 5 11 5 5 5 5 5 5 2 
 9 3 3 3 3 3 3 3 11 3 3 3 3 3 3 8
